10
........==
.P.====.==
========.=
===......=
==.=======
===.===...
===....==.
========..
.=.......=
=O========