10
.......===
.======..=
.O....===.
=======.=.
======....
..........
======.===
=..P.=....
.=======..
=.........