10
...=...===
.======..=
.O....===.
==.====.=.
======....
......==..
.=====.===
=..P.=....
========..
=.........