15
.......========
.======..======
.P....===.=====
=======.=....==
======....==.==
...........====
.==============
.==============
.======......==
.==.....=.=====
...======.=====
======..==.====
=......=O.=....
.===========..=
=............==